NO ./mandatory/textures/4.xpm
SO ./mandatory/textures/3.xpm
WE ./mandatory/textures/2.xpm
EA ./mandatory/textures/1.xpm


F 102,0,0
C 135,206,235


        111111111111111111111111
        1000000000110000000000001
        1011000000010000001000001
        1001000000000000000100001
111111111011000001110000011000001
10000000000000001010111111111111
11110111111111000100000010001
11110111111111011001010010001
11000000110101011100000010001
10000000001000001100000010001
100000000001000000010100000001
100000000001000000010100000001
10000000000100N000000000000001
100000000001000000010100000001
100000000001000000010100000001
11000001111111111101111000111
11110111         101111010001
11111111         111111111111