
NO ./textures/4.xpm
SO ./textures/3.xpm
WE ./textures/2.xpm
EA ./textures/1.xpm

C 135,206,0,0
F 102,0,0

       1111111111111111111111111
       10000000001100000000000001
       1011000000010000001000001
       1001000000000000000100001
111111111011000001110000011000001
10000000000000001010111111111111
11110111111111000100000010001
11110111111111011001010010001
11000000110101011100000010001
1000000000100000110S000010001
100000000001000000010100000001
100000000001000000010100000001
100000000001000000000000000001
100000000001000000010100000001
100000000001000000010100000001
110000011111111111011110001111
11110111         101111110001
11111111         111111111111