111111111
101000001
100010001
111111111