NO ./path_to_the_north_texture
SO ./path_to_the_south_texture
WE ./path_to_the_west_texture
EA ./path_to_the_east_texture


F 220,80, 255
C 0,0,0


        111111111111111111111111
        1000000000110000000000001
        1011000000010000001000001
        1001000000100000E00100001
111111111011000001110000011000001
10000000001100001010111111111111
11110111111111000100000010001
11110111111111011001010010001
11000000110101011100000010001
10000000001000001100000010001
10000000000100000001010000001
11000001111111111101111000111
11110111         101111010001
11111111         111111111111