NO ./path_to_the_north_texture
SO ./path_to_the_south_texture
WE ./path_to_the_west_texture
EA ./path_to_the_east_texture


F 220,80, 255
C 0,0,0


111111111111111111111111
100000000011000000000001
100000000011000000000001
100000000000000000N00001
100000000011000000000001
111111111111111111111111