NO ./path_to_the_north_texture
SO ./path_to_the_south_texture
WE ./path_to_the_west_texture
EA ./path_to_the_east_texture


F 220,100,0
C 225,30,0


11111111111111111111111111
1000000001100100000000001
1011000001110000000000001  
10010000000000000000000011111111 
1111111110110000011111111111111111
1111110000011000001110111111111111   
11111111111111011100000010001
11111111111111011101010010001  111
11000000110101011100000000001  101
10000000000000001100000000001  111
11111111111111111111111111111
1    1
11111111111111111111111111111
1000000011000001101010010001	
110000011 1101011111011110N0111  
111101111 1101011101111010001
111111111 11111111111111111111111