NO ./path_to_the_north_texture
SO ./path_to_the_south_texture
WE ./path_to_the_west_texture
EA ./path_to_the_east_texture


F 220,80, 255
C 0,0,0


111111111111111111111111
1111111111111111111111111
10000000001100000000000001
10110000011100N0000000001
1001000000000000000000001
11111111101100000111000011111111
100000000011000001110111111111111
11110111111111011100000010001
11110111111111011101010010001
11000000110101011100000010001
10000000000000001100000010101
10000000000000001101010100011
1100000111010101111101111000111
11110111 1110101 101111010001
11111111 1111111 111111111111